11111111111111
10000PP0000001
100000c0000001
1EEcccccP00001
11111111111111