11111111111111111111111111111111111111111111111111111111111
10000000000000000000000000000000000000000000000000000000001
10000000011100000000000000000000000000000000000000000000001
10000001111111000000000000000000000000000000000000000000001
10000011111111100000000000000000000000000000000000000000001
10000011111111100000000000000000000000000000000000000000001
10000111111111110000000000000000000000000000000000000000001
10000111111111110000000000000000000000000000000000000000001
10000111111111110000000000000000000000000000000000000000001
10000011111111100000000000000000000000000000000000000000001
10000011111111111111111111111111111111111111100000000000001
100000011111111111111111111111111111111111111110c00c0c0c0P1
100000E1111111111111111111111111111111111111111000000000001
10000011111111111111111111111111111111111111100000000000001
10000011111111100000000000000000000000000000000000000000001
10000111111111110000000000000000000000000000000000000000001
10000111111111110000000000000000000000000000000000000000001
10000111111111110000000000000000000000000000000000000000001
10000011111111100000000000000000000000000000000000000000001
10000011111111100000000000000000000000000000000000000000001
10000001111111000000000000000000000000000000000000000000001
10000000011100000000000000000000000000000000000000000000001
10000000000000000000000000000000000000000000000000000000001
11111111111111111111111111111111111111111111111111111111111