111111111111111
1000000100010P1
101100000c11101
1c100001111E111
111110000000011
111111111111111