111111111111111
1000000100000P1
101100000C11101
1C100001111E111
111110000X00011
111111111111111