1111111111
10000E0001
10c0000001
1111111111
1000000001
10000P0001
1111111111