11111011
10000P01
10111001
10E110c1
11111111