1111111111111111111111111111111111111111111
1000000000000E00001000000111000000000001001
111110111111111101c111111100000000100000111
11P0011111111110000c00011111110000111111111
10000000000001111111000c11111111100000000c1
1000000000000000000000000000000000000000001
1111111111111111111111111111111111111111111