1111111
1E111P1
1010c01
1111111