1111111111111111111111
1CE00000000000000000P1
1000000000000000000001
1XX0000000000000000001
11100000X0000000000001
1111111110000000000001
1111000000000000000001
1000X000000X00000X0001
1111111111111111111111