11111111111111
10000000000000001
1000000000001
100000000000001
111111111111111