NO  textures/1.xpm
SO  textures/2.xpm
WE  textures/3.xpm
EA  textures/4.xpm
F   40,10,10
C   200,11,22


111111111
100000001
101111101
101000101
101N10001
101111101
100000001
111111111